EA assets/crystal.xpm
WE assets/crystal.xpm

NO assets/crystal.xpm
C 225,255,255
F 220,16,  1
SO assets/crystal.xpm   


11111111
101 0010111  11111   1
11 1 011101 1 001    111
1N1111101 11111  11111               111    
                           101
                           11           
    11111111 1111111111
    111111111111111111
