EA ./assests/east.xpm
WE ./assests/west.xpm

NO ./assests/north.xpm
C 225,30,255
F 220, 1,6
SO ./assests/south.xpm   


1111111111  
1010010101  11111   111
1N1011101 10001    101
1010011101 11111  11111    111
111111111111111111