EA ./assests/east.xpm
WE ./assests/west.xpm

NO ./assests/north.xpm
C 225,255,255
F 220,16,1
SO ./assests/south.xpm   


11111111
1010010111  11111   1
111011101 10001    101
1N1011101 11111  11111               111    
                           101
                           11
111111111111111111
