EA assets/crystal.xpm
WE assets/crystal.xpm

NO assets/crystal.xpm
C 225,255,255
F 220,16,  1
SO assets/crystal.xpm  


        1111111111111111111111111
        1000000000110000000000001
        1011000001110000000000001
        100100000 000000000000001111111111
11111111101100 0  001110000000000001
100000000011000 1110111111111111111111111
111101111111110 1100000010001
11110111111 111011101010010001
11000000110101011100000 010001
10000000000000 001100000010001
10000000 000000001101010010001
11000001110101011111011110N01
11110111 1110101 101111010001
11111111 1111111 111111111111